111111111111111111
100000000000001001
100P10000000001001
100000001010001001
100000001C10000001
100000001110000001
100000000001111101
100000000001E00001
111111111111111111