111111111111111111
1P0C00000000001C01
100C00000000001001
100C00000000001001
100C00000000000001
100C00000000000001
100C00000001111001
100C00000001000001
100C00000001000001
100C00000001E00001
111111111111111111