111111111111111111
1000C0000000001001
100P00000000001001
100000000000001001
100000000000000001
100000000000000001
100000000001111101
100000000001E00001
111111111111111111
